  #################################################
        #       #                 #   # #     # # B
# # # # ### # # # ##### # # ### # ### # # # # # # #
# # # # # # # # # # #   # #   # # #     # # #     #
####### # ##### # # ##### ### ##### # # ##### ### #
# #   # # # #         # #   #       # # #       # #
# # # # # # ########### ####### # ####### ##### # #
#   #       #   #             # #       #   #   # #
# # ########### ### # ### # # ### # ####### ### # #
# #       # #   #   # #   # #     #   #   #   # # #
# # ####### # # # ##### ######### ##### # ####### #
# #       #   #     #   #               #         #
# ##### ### # ### # # ####### ##### ##### ### # ###
#   # # #   # #   # #   #   # # #     # # # # #   #
##### # ##### # ### ####### # # # # ### ### ##### #
#         # # # #   #   #       # #       #     # #
### ##### # ####### # # ####### ######### ##### # #
#   #               # # # # #     # #     # # #   #
### ##### ####### ### ### # ##### # # # # # # ### #
A       #       #         #       #   # #     #    
#################################################  
